#######################################################################################################################################################################################################
#.....................................................................................................................................................................................................#
#.....................................................................................................................................................................................................#
#.....................................................................................................................................................................................................#
#.....................................................................................................................................................................................................#
#.....................................................................................................................................................................................................#
#.....................................................................................................................................................................................................#
#.....................................................................................................................................................................................................#
#.....................................................................................................................................................................................................#
#.....................................................................................................................................................................................................#
#.....................................................................................................................................................................................................#
#.....................................................................................................................................................................................................#
#.....................................................................................................................................................................................................#
#.....................................................................................................................................................................................................#
#.....................................................................................................................................................................................................#
#.....................................................................................................................................................................................................#
#.....................................................................................................................................................................................................#
#.....................................................................................................................................................................................................#
#.....................................................................................................................................................................................................#
#.....................................................................................................................................................................................................#
#.....................................................................................................................................................................................................#
#.....................................................................................................................................................................................................#
#.....................................................................................................................................................................................................#
#.....................................................................................................................................................................................................#
#.....................................................................................................................................................................................................#
#.....................................................................................................................................................................................................#
#.....................................................................................................................................................................................................#
#.....................................................................................................................................................................................................#
#.....................................................................................................................................................................................................#
#.....................................................................................................................................................................................................#
#.....................................................................................................................................................................................................#
#.....................................................................................................................................................................................................#
#.....................................................................................................................................................................................................#
#.....................................................................................................................................................................................................#
#.....................................................................................................................................................................................................#
#.....................................................................................................................................................................................................#
#.....................................................................................................................................................................................................#
#.....................................................................................................................................................................................................#
#.....................................................................................................................................................................................................#
#.....................................................................................................................................................................................................#
#.....................................................................................................................................................................................................#
#...........................................................__________..................................................__________....................................................................#
#........................................................../-========-\................................................/-========-\...................................................................#
#.........................................................//          \\______________________________________________//          \\..................................................................#
#........................................................//            \-============================================-/            \\.................................................................#
#.......................................................||                                                                          ||................................................................#
#.......................................................||                                                                          ||................................................................#
#........................................................\\                                                                        //.................................................................#
#.........................................................||                                                                      ||..................................................................#
#.........................................................||                                                          .           ||..................................................................#
#.........................................................||                                               .         ;            ||..................................................................#
#.........................................................||                  .              .              ;%     ;;             ||..................................................................#
#.........................................................||                    ,           ,                :;%  %;              ||..................................................................#
#.........................................................||                     :         ;                   :;%;'     .,       ||..................................................................#
#.........................................................||            ,.        %;     %;            ;        %;'    ,;         ||..................................................................#
#.........................................................||              ;       ;%;  %%;        ,     %;    ;%;    ,%'          ||..................................................................#
#.........................................................||               %;       %;%;      ,  ;       %;  ;%;   ,%;'           ||..................................................................#
#.........................................................||                ;%;      %;        ;%;        % ;%;  ,%;'             ||..................................................................#
#.........................................................||                 `%;.     ;%;     %;'         `;%%;.%;'               ||..................................................................#
#.........................................................||                  `:;%.    ;%%. %@;        %; ;@%;%'                  ||..................................................................#
#.........................................................||                     `:%;.  :;bd%;          %;@%;'                    ||..................................................................#
#.........................................................||                       `@%:.  :;%.         ;@@%;'                     ||..................................................................#
#.........................................................||                         `@%.  `;@%.      ;@@%;                       ||..................................................................#
#.........................................................||                           `@%%. `@%%    ;@@%;                        ||..................................................................#
#.........................................................||                             ;@%. :@%%  %@@%;                         ||..................................................................#
#.........................................................||                               %@bd%%%bd%%:;                          ||..................................................................#
#.........................................................||                                 #@%%%%%:;;                           ||..................................................................#
#.........................................................||                                 %@@%%%::;                            ||..................................................................#
#.........................................................||                                 %@@@%(o);  . '                       ||..................................................................#
#.........................................................||                                 %@@@o%;:(.,'                         ||..................................................................#
#.........................................................||                             `.. %@@@o%::;                            ||..................................................................#
#.........................................................||                                `)@@@o%::;                            ||..................................................................#
#.........................................................||                                 %@@(o)::;                            ||..................................................................#
#.........................................................||                                .%@@@@%::;                            ||..................................................................#
#.........................................................||                                ;%@@@@%::;                            ||..................................................................#
#.........................................................||                               ;%@@@@%%:;;;.                          ||..................................................................#
#.........................................................||                           ...;%@@@@@%%:;;;;,..                       ||..................................................................#
#.........................................................||                                                                      ||..................................................................#
#.........................................................||                                                                      ||..................................................................#
#.........................................................||                                                                      ||..................................................................#
#.........................................................||                                                                      ||..................................................................#
#.........................................................||                                                                      ||..................................................................#
#.........................................................||                                                                      ||..................................................................#
#........................................................//                                                                        \\.................................................................#
#.......................................................||                                                                          ||................................................................#
#.......................................................||              __________________          __________________              ||................................................................#
#........................................................\\            /-================-\        //-===============-\            //.................................................................#
#.........................................................\\__________//..................\\      //..................\\__________//..................................................................#
#..........................................................\-========-/....................||    ||....................\-========-/...................................................................#
#..........................................................................................==    ==...................................................................................................#
#.....................................................................................................................................................................................................#
#.....................................................................................................................................................................................................#
#.....................................................................................................................................................................................................#
#######################################################################################################################################################################################################